Avg
BibTeX
C
CD
DD
E
Emacs
Email
F
FAX
H
HOSTNAME
INSCC
ISBN
M
N
O
RM
ROMs
S
Solaris
TB
Tb
URL
UT
UltraSPARC
WWW
YYYY
aardvark
arg
beebe
bool
cursize
defun
docstrings
edu
el
elisp
emacs
funct
gperf
h
hash
hashtable
hh
html
http
info
inlined
knuth
lessp
lg
lowercase
mapatoms
mapcar
math
maxsize
obarray
obarrays
org
p
pp
prin
s
smallexample
ss
t
tb
tex
texi
texinfo
utah
www
x
